6  6  9
1  4  2  1  h
3  2  1  3  v
2  1  2  1  h
4  1  1  3  v
6  1  1  1  v
1  1  1  1  n
5  2  2  2  h
1  5  1  2  v
2  5  1  2  v
3  5  2  2  h
