5  6  5
2  2  2  1  h
1  1  1  3  v
1  4  1  3  v
3  3  1  2  v
4  4  2  1  h
4  1  1  2  v
4  3  2  1  h
2  5  2  2  h
