6  6
3  2  2  1  h
1  1  1  3  v
1  4  1  3  v
4  3  1  2  v
5  4  3  1  h
5  6  1  2  v
5  3  3  1  h